date,Owners,Price,PriceChangeTo,discount,total_reviews,total_positive,total_negative,review_score
2015-04-02,38000,0.0,49.99,,0,0,0,0
2015-06-11,176000,49.99,37.49,74.99,2178,1776,402,8
2015-06-19,205000,37.49,29.99,79.99,2377,1933,444,8
2015-06-22,209000,29.99,49.99,166.69,2498,2020,478,8
2015-09-10,254000,49.99,29.99,59.99,3401,2660,741,6
2015-09-14,256000,29.99,49.99,166.69,3476,2713,763,6
2015-11-25,284000,49.99,24.99,49.99,4019,3143,876,6
2015-12-01,292000,24.99,49.99,200.04,4082,3195,887,6
2015-12-22,316000,49.99,19.99,39.99,4240,3323,917,6
2016-01-04,335000,19.99,49.99,250.08,4530,3549,981,6
2016-02-05,360000,49.99,19.99,39.99,4857,3795,1062,6
2016-02-12,363000,19.99,49.99,250.08,4956,3868,1088,6
2016-05-06,375000,49.99,29.99,59.99,5471,4266,1205,6
2016-06-23,425000,29.99,14.99,49.98,5837,4533,1304,6
2016-07-04,446000,14.99,29.99,200.07,6015,4663,1352,6
2016-10-06,511000,29.99,14.99,49.98,6508,5022,1486,6
2016-10-10,532000,14.99,29.99,200.07,6566,5064,1502,6
2016-11-23,554000,29.99,11.99,39.98,6782,5227,1555,6
2016-11-29,565000,11.99,29.99,250.13,7226,5644,1582,6
2016-12-22,600000,29.99,9.89,32.98,7374,5771,1603,6
2017-01-02,642000,9.89,29.99,303.24,7580,5921,1659,6
2017-02-08,809000,29.99,10.19,33.98,7878,6129,1749,6
2017-02-10,819000,10.19,29.99,294.31,7952,6179,1773,6
2017-06-08,882000,29.99,10.19,33.98,8647,6690,1957,6
2017-06-10,868000,10.19,29.99,294.31,8698,6728,1970,6
2017-06-22,902000,29.99,9.89,32.98,8822,6818,2004,6
2017-07-05,925000,9.89,29.99,303.24,9076,6995,2081,6
2018-06-21,900000,29.99,7.49,24.97,10224,7850,2374,6
2018-07-05,912000,7.49,29.99,400.4,10274,7887,2387,6
2018-11-01,950000,29.99,7.49,24.97,10397,7962,2435,6
2018-11-05,952000,7.49,29.99,400.4,10411,7973,2438,6
2018-11-21,956000,29.99,7.49,24.97,10431,7984,2447,6
2018-11-27,957000,7.49,29.99,400.4,10564,8111,2453,6
2018-12-20,962000,29.99,7.49,24.97,10598,8136,2462,6
2019-01-03,973000,7.49,29.99,400.4,10630,8154,2476,6
2019-02-04,982000,29.99,7.49,24.97,10666,8179,2487,6
2019-02-11,988000,7.49,29.99,400.4,10680,8190,2490,6
2019-06-25,1041000,29.99,7.49,24.97,10832,8278,2554,6
2019-07-09,1047000,7.49,29.99,400.4,11003,8438,2565,6
2019-09-05,1070000,29.99,7.49,24.97,11056,8475,2581,6
2019-09-09,1076000,7.49,29.99,400.4,11065,8481,2584,6
2019-11-09,1105000,29.99,7.49,24.97,11122,8524,2598,6
2019-11-12,1104000,7.49,29.99,400.4,11125,8526,2599,6
2019-11-26,1112000,29.99,7.49,24.97,11178,8573,2605,6
2019-12-03,1116000,7.49,29.99,400.4,11225,8618,2607,6
2019-12-19,1106000,29.99,7.49,24.97,11265,8653,2612,6
2020-01-02,1114000,7.49,29.99,400.4,11315,8696,2619,6
2020-01-23,1021000,29.99,7.49,24.97,11366,8740,2626,6
2020-01-27,1005000,7.49,29.99,400.4,11375,8748,2627,6
2020-04-30,1024000,29.99,5.99,19.97,11602,8947,2655,6
2020-05-06,1029000,5.99,29.99,500.67,11638,8980,2658,6
2020-09-17,1067000,29.99,19.99,66.66,11965,9260,2705,6
2020-10-22,1078000,19.99,4.99,24.96,12029,9315,2714,6
2020-10-26,1085000,4.99,19.99,400.6,12052,9334,2718,6
2020-10-29,1084000,19.99,4.99,24.96,12065,9345,2720,6
2020-11-02,1088000,4.99,19.99,400.6,12083,9361,2722,6
2020-11-25,1089000,19.99,4.99,24.96,12155,9430,2725,6
2020-12-01,1092000,4.99,19.99,400.6,12177,9452,2725,6
2020-12-22,1097000,19.99,4.99,24.96,12225,9494,2731,6
2021-01-05,1103000,4.99,19.99,400.6,12292,9554,2738,6
2021-01-15,1106000,19.99,4.99,24.96,12321,9580,2741,6
2021-01-29,1123000,4.99,19.99,400.6,12416,9661,2755,6
2021-02-12,1118000,19.99,4.99,24.96,12469,9707,2762,6
2021-02-15,1118000,4.99,19.99,400.6,12480,9717,2763,6
2021-03-29,1103000,19.99,4.99,24.96,12605,9823,2782,6
2021-04-12,1120000,4.99,19.99,400.6,12689,9895,2794,6
2021-05-28,1124000,19.99,14.99,74.99,12819,10009,2810,6
2021-06-10,1127000,14.99,3.74,24.95,12854,10039,2815,6
2021-07-08,1143000,3.74,14.99,400.8,12960,10124,2836,6
2021-07-30,1144000,14.99,4.49,29.95,13008,10170,2838,6
2021-08-10,1151000,4.49,14.99,333.85,13043,10203,2840,6
2021-09-21,1160000,14.99,4.49,29.95,13137,10285,2852,6
2021-10-04,1167000,4.49,14.99,333.85,13175,10318,2857,6
2021-11-24,1178000,14.99,4.49,29.95,13291,10418,2873,6
2021-11-30,1182000,4.49,14.99,333.85,13326,10450,2876,6
2021-12-22,1193000,14.99,4.49,29.95,13384,10502,2882,6
2022-01-05,1198000,4.49,14.99,333.85,13418,10532,2886,6
2022-01-26,1204000,14.99,4.49,29.95,13457,10564,2893,6
2022-02-11,1213000,4.49,14.99,333.85,13493,10594,2899,6
2022-03-14,1221000,14.99,4.49,29.95,13565,10657,2908,6
2022-03-28,1233000,4.49,14.99,333.85,13606,10691,2915,6
2022-06-22,1256000,14.99,4.49,29.95,13746,10812,2934,6
2022-07-07,1261000,4.49,14.99,333.85,13769,10832,2937,6
2022-07-18,1264000,14.99,4.49,29.95,13781,10842,2939,6
2022-07-25,1271000,4.49,14.99,333.85,13801,10860,2941,6
2022-08-22,1276000,14.99,4.49,29.95,13844,10897,2947,6
2022-09-05,1002000,4.49,14.99,333.85,13894,10938,2956,6
2022-10-18,1291000,14.99,4.49,29.95,13967,11004,2963,6
2022-11-01,1297000,4.49,14.99,333.85,14002,11033,2969,6
